VERSION,1,,,,,,,,,,,,,,,,,,,,,,,,,,,,,,,,
13,14,,,,13,14,,,,13,14,,,,13,14,,,,13,14,,,,13,14,,,,13,14,,
15,15,,,,15,15,,,,15,15,,,,15,15,,,,15,15,,,,15,15,,,,15,15,,
15,15,,21,,15,15,,21,,15,15,,21,,15,15,,21,,15,15,,21,,15,15,,21,,15,15,,21
15,15,,,,15,15,,,,15,15,,,,15,15,,,,15,15,,,,15,15,,,,15,15,,
15,15,,,,15,15,,,,15,15,,,,15,15,,,,15,15,,,,15,15,,,,15,15,,
