VERSION,1,,,,,,,,,,,,,,,,,,,,,,,,,,,,,,,,
13,14,,,,13,14,,,,13,14,,,,13,14,,,,13,14,,,,13,14,,,,13,14,,
15,15,,,,15,15,,,,15,15,,,,15,15,,,,15,15,,,,15,15,,,,15,15,,
15,15,,20,,15,15,,20,,15,15,,20,,15,15,,20,,15,15,,20,,15,15,,20,,15,15,,20
15,15,,,,15,15,,,,15,15,,,,15,15,,,,15,15,,,,15,15,,,,15,15,,
15,15,,,,15,15,,,,15,15,,,,15,15,,,,15,15,,,,15,15,,,,15,15,,
