VERSION,1,,,,,,,,,,,,,
0x01,0x01,0x01,0x01,0x01,0x01,0x01,0x01,0x01,0x01,0x01,0x01,0x01,0x01,0x01
0x01,,,,,,,,,,,,,,0x01
0x01,,,,,,,,,,,,,,0x01
0x01,,0x02,,0x02,,,0x02,,,0x02,0x02,,,0x01
0x01,,0x02,0x02,0x02,,0x02,,0x02,,0x02,,0x02,,0x01
0x01,,0x02,,0x02,,0x02,,0x02,,0x02,,0x02,,0x01
0x01,,0x02,,0x02,,0x02,0x02,0x02,,0x02,0x02,,,0x01
0x01,,0x02,,0x02,,0x02,,0x02,,0x02,,,,0x01
0x01,,0x02,,0x02,,0x02,,0x02,,0x02,,,,0x01
0x01,,,,,,,,,,,,,,0x01
0x01,,,,,,,,,,,,,,0x01
0x01,0x06,0x06,0x06,0x06,0x06,0x06,0x06,0x06,0x06,0x06,0x06,0x06,0x06,0x01
0x01,0x05,0x05,0x05,0x05,0x05,0x05,0x05,0x05,0x05,0x05,0x05,0x05,0x05,0x01
0x01,0x05,0x05,0x05,0x05,0x05,0x05,0x05,0x05,0x05,0x05,0x05,0x05,0x05,0x01
0x01,0x05,0x05,0x05,0x05,0x05,0x05,0x05,0x05,0x05,0x05,0x05,0x05,0x05,0x01
0x01,0x05,0x05,0x05,0x05,0x05,0x05,0x05,0x05,0x05,0x05,0x05,0x05,0x05,0x01
0x01,0x05,0x05,0x05,0x05,0x05,0x05,0x05,0x05,0x05,0x05,0x05,0x05,0x05,0x01
0x01,0x05,0x05,0x05,0x05,0x05,0x05,0x05,0x05,0x05,0x05,0x05,0x05,0x05,0x01
0x01,0x05,0x05,0x05,0x05,0x05,0x05,0x05,0x05,0x05,0x05,0x05,0x05,0x05,0x01
0x01,0x01,0x01,0x01,0x01,0x01,0x01,0x01,0x01,0x01,0x01,0x01,0x01,0x01,0x01
